11211112111222222111
12222212211111121121
11111112121222121221
12222222121211121121
11111111121212222121
22121222121211111121
11121211121222222221
22221212221211111111
11111211111212222222
22222222221212111111
11111111121112122221
12222222112121121111
11111111211111211222
22222221112222112111
11111112111111111111
21222211212222222221
11211121112111112121
21212112211122211121
11111211222221112221
21212111111111211111
